# ğŸ”§ BÃ¡sicos do terminal
alias ll='ls -lha'
alias la='ls -A'
alias ..='cd ..'
alias ...='cd ../..'
alias c='clear'
alias h='history'
alias path='echo $PATH | tr ":" "\n"'
alias now='date +"%Y-%m-%d %H:%M:%S"'

# ğŸ™ Git
alias g='git'
alias gs='git status'
alias ga='git add .'
alias gc='git commit -m'
alias gca='git commit --amend'
alias gp='git push'
alias gpo='git push origin'
alias gl='git log --oneline --graph --all'
alias gb='git branch'
alias gco='git checkout'
alias gcb='git checkout -b'
alias gpull='git pull origin $(git branch --show-current)'
alias gpush='git push origin $(git branch --show-current)'

# ğŸ³ Docker
alias d='docker'
alias dps='docker ps'
alias dpa='docker ps -a'
alias di='docker images'
alias drm='docker rm'
alias drmi='docker rmi'
alias dstop='docker stop $(docker ps -q)'
alias dclean='docker system prune -af --volumes'

# â˜¸ï¸ Kubernetes
alias k='kubectl'
alias kgp='kubectl get pods'
alias kgs='kubectl get svc'
alias kga='kubectl get all'
alias kl='kubectl logs'
alias kaf='kubectl apply -f'
alias kdf='kubectl delete -f'
alias kctx='kubectl config current-context'
alias kx='kubectl config use-context'
alias kns='kubectl config set-context --current --namespace'

# ğŸ§° Ferramentas & DevOps
alias tf='terraform'
alias tfa='terraform apply'
alias tfi='terraform init'
alias tfd='terraform destroy'
alias tfo='terraform output'
alias tfs='terraform show'
alias v='nvim'
alias py='python3'
alias pipup='pip install --upgrade pip'

# ğŸ› ï¸ Customizados Ãºteis
alias serve='python3 -m http.server'
alias weather='curl wttr.in'
alias ips='ip -4 addr | grep inet'
alias myip='curl ifconfig.me'
alias psg='ps aux | grep -i'
